11111111111111111
11111110000100001
00000110101101101
11110110101101121
11110110100020101
11110000101110101
11110111101110101
10000010101110101
10111010101110111
10111010100000000
10101010111101101
10101010111101101
10001010001101101
11101010100101101
10101010111101001
10001010000001101
10111011111101111
